Archery	Baseball
Basketball	Billiards
Badminton	Boxing
Bowling	Bungee Jumping
Cricket	Cycling
Chess	Diving
Dodgeball	Fencing
Figure Skating	Football
Golf	Handball
Hockey	Horseback Riding
Ice Hockey	Judo
Karate	Kickboxing
Kayaking	Lacrosse
Mixed Martial Arts	Muay Thai
Paragliding	Paintball
Rowing	Rugby
Skateboarding	Shooting
Swimming	Surfing
Taekwondo	Table Tennis
Volleyball	Water Polo
Wrestling	Weight Lifting